	
responsible/reliable/trustworthy 	Отвественный
bossy/dictatorial 	Любящий командовать
energetic/active/lively 	Активный
self-centered/selfish 	Самовлюбленный
determined/decided/decisive/confident 	Решительный
reserved/blank 	Пустой
secretive 	Скрытный
emotional/passionate/hot-blooded 	Эмоциональный
immediate/direct 	Прямой
mean/thrifty/economical/materialistic 	Жадный
generous 	Щедрый
possessive/jealous/envious/covetous 	Завистливый
sensitive/impressionable 	Чувствительный
cold-blooded/cool-hearted/dispassionate 	Бесчувственный
intelligent/genius/wise/smart/quick-witted 	Умный
arrogant/proud/conceited/vain 	Гордый
haughty/hostile/unfriendly 	Враждебный
cooperative/obedient/law-abiding 	Послушный
shy/timid 	Застенчивый
humble/modest 	Скромный
absent-minded/forgetful 	Забывчивый
loyal/faithful 	Преданный
aggressive/rude/impolite 	Агрессивный
authoritarian/strict/severe/stern 	Строгий
boastful 	Хвастливый
compassionate/sympathetic/supportive 	Сострадательный
competitive/ambitious 	Амбициозный
confident/self-confident/self-assured 	Уверенный в себе
curious/inquisitive 	Любопытный
disciplined 	Дисциплинированный
easy-going/relaxed/light-hearted/carefree/careless 	Беззаботный
careful/diligent/petty/meticulous/thorough/cautious 	Аккуратный
hardworking/industrious/efficient/productive 	Трудолюбивый
lazy 	Ленивый
enthusiastic/keen/eager 	Энтузиаст
gentle/nice/empathetic/considerate 	Тактичный
shallow/impulsive 	Поверхностный
stable/well-balanced 	Уравновешенный
creative/resourceful/inventive 	Креативный
immature 	Инфантильный
indecisive 	Нерешительный
innocent/sincere/honest 	Честный
insincere/two-faced/dishonest 	Бесчестный
intellectual/sensible/reasonable/logical 	Логичный
intolerant/stubborn 	Упертый
moody 	Унылый
narrow-minded/conservative 	Консервативный
open-minded/liberal 	Либеральный
outgoing/communicative/sociable 	Общительный
patient 	Терпеливый
pessimistic/resigned 	Пессимистичный
rebellious/disobedient 	Непослушный
strong-willed 	Волевой
tactless  	Бестактный
unpredictable 	Непредсказуемый
unprincipled 	Беспринципный
cheerful/life-affirming 	Беззаботный
content(ed)/happy/satisfied 	Счастливый
insecure/screwed up/having low self-esteem 	Неуверенный в себе
